XXXXXXXXXXXXXXXXXXXXXXXXXXXX
XOOOOOOOOOOOOXXOOOOOOOOOOOOX
XOXXXXOXXXXXOXXOXXXXXOXXXXOX
XOXXXXOXXXXXOXXOXXXXXOXXXXOX
XOXXXXOXXXXXOXXOXXXXXOXXXXOX
XOOOOOOOOOOOOOOOOOOOOOOOOOOX
XOXXXXOXXOXXXXXXXXOXXOXXXXOX
XOXXXXOXXOXXXXXXXXOXXOXXXXOX
XOOOOOOXXOOOOXXOOOOXXOOOOOOX
XXXXXXOXXXXX XX XXXXXOXXXXXX
XXXXXXOXXXXX XX XXXXXOXXXXXX
XXXXXXOXX          XXOXXXXXX
XXXXXXOXX XXXXXXXX XXOXXXXXX
XXXXXXOXX XXXXXXXX XXOXXXXXX
      O   XXXXXXXX   O      
XXXXXXOXX XXXXXXXX XXOXXXXXX
XXXXXXOXX XXXXXXXX XXOXXXXXX
XXXXXXOXX          XXOXXXXXX
XXXXXXOXX XXXXXXXX XXOXXXXXX
XXXXXXOXX XXXXXXXX XXOXXXXXX
XOOOOOOOOOOOOXXOOOOOOOOOOOOX
XOXXXXOXXXXXOXXOXXXXXOXXXXOX
XOXXXXOXXXXXOXXOXXXXXOXXXXOX
XOOOXXOOOOOOO POOOOOOOXXOOOX
XXXOXXOXXOXXXXXXXXOXXOXXOXXX
XXXOXXOXXOXXXXXXXXOXXOXXOXXX
XOOOOOOXXOOOOXXOOOOXXOOOOOOX
XOXXXXXXXXXXOXXOXXXXXXXXXXOX
XOXXXXXXXXXXOXXOXXXXXXXXXXOX
XOOOOOOOOOOOOOOOOOOOOOOOOOOX
XXXXXXXXXXXXXXXXXXXXXXXXXXXX