XXXXXXXXXXXXXXXXXXXXXXXXXXXX
XOOOOOOOOOOOOXXOOOOOOOOOOOOX
XOXXXXOXXXXXOXXOXXXXXOXXXXOX
XOX  XOX   XOXXOX   XOX  XOX
XOXXXXOXXXXXOXXOXXXXXOXXXXOX
XOOOOOOOOOOOOOOOOOOOOOOOOOOX
XOXXXXOXXOXXXXXXXXOXXOXXXXOX
XOXXXXOXXOXXXXXXXXOXXOXXXXOX
XOOOOOOXXOOOOXXOOOOXXOOOOOOX
XXXXXXOXXXXX XX XXXXXOXXXXXX
     XOXXXXX XX XXXXXOX     
     XOXX    B     XXOX     
     XOXX XXXXXXXX XXOX     
XXXXXXOXX X      X XXOXXXXXX
XXXXXXO  RX      XY  OXXXXXX
XXXXXXOXX X      X XXOXXXXXX
     XOXX XXXXXXXX XXOX     
     XOXX     M    XXOX     
     XOXX XXXXXXXX XXOX     
XXXXXXOXX XXXXXXXX XXOXXXXXX
XOOOOOOOOOOOOXXOOOOOOOOOOOOX
XOXXXXOXXXXXOXXOXXXXXOXXXXOX
XOXXXXOXXXXXOXXOXXXXXOXXXXOX
XOOOXXOOOOOOO POOOOOOOXXOOOX
XXXOXXOXXOXXXXXXXXOXXOXXOXXX
XXXOXXOXXOXXXXXXXXOXXOXXOXXX
XOOOOOOXXOOOOXXOOOOXXOOOOOOX
XOXXXXXXXXXXOXXOXXXXXXXXXXOX
XOXXXXXXXXXXOXXOXXXXXXXXXXOX
XOOOOOOOOOOOOOOOOOOOOOOOOOOX
XXXXXXXXXXXXXXXXXXXXXXXXXXXX